fur-maze-ing..(help)
....................
000000.......000000.
0....0.......0....0.
0....0.......0....0.
0....0.0...0.0....0.
0....0.0.0.0.0....0.
0....0.0.0.0.0....0.
000000_00000_000000_
....................
....................
....................
....................
....................
....................
....................
....................
....................
....................
try_to_escape.>w<___
