00000000000000000000
0        0         0
0        0       2 0
0        0         0
0        0         0
0        0         0
0        0         0
0        0         0
0        0         0
0        0         0
01       0        10
0        0         0
0        0         0
0        0         0
0        0         0
0        0         0
0        0         0
0 3      0         0
0        0         0
00000000000000000000
